11111111111111111111111111
11E000000000000C00000000C1
10100101001000001010210111
10100100101010100010010001
1P0000000C00C00000000000C1
11111111111111111111111111
